..#....#..
.#........
......#...
...#......
.#...##.#.
..#...#...
.......#.#
..#.....#.
....#.#...
..#.#..##o
==========
..#....#..
.#........
......#...
...#......
.#...##.#.
..#...#...
.......#.#
..#.....#.
....#.#...
..#.#..##o
==========
..#....#..
.#........
......#...
...#......
.#...##.#.
..#...#...
.......#.#
..#.....#.
....#.#...
..#.#..##o
==========
..#....#..
.#........
......#...
...#......
.#...##.#.
..#...#...
.......#.#
..#.....#.
....#.#...
..#.#..##o
==========
..#....#..
.#........
......#...
...#......
.#...##.#.
..#...#...
.......#.#
..#.....#.
....#.#...
..#.#..##
==========
